<ASYNC>	Произошла ошибка при асинхронной обработке предыдущей команды SET или KILL в удаленной группе томов. Эта ошибка подавляется, только если она не разрешена специально флагом режима, устанавливаемым утилитами SYSGEN или %MODESET. Тип ошибки указывается в поле дополнительной информации в $ZERROR. Это число формируется как старший*256+младший. 
<BADCH>	Обнаружен незаконный символ. 
<BKERR>	Интерпретатор обнаружил команду BREAK в процессе выполнения программы. Команда BREAK используется для отладки программ и позволяет пользователю просматривать программу, локальные и глобальные переменные в определенной точке программы. Выполнение программы можно возобновить посредством команды ZGO. 
<CLOBR>	Сделана попытка перекрыть текущую программу командами ZLOAD, ZREMOVE или ZINSERT изнутри программы.
<CMMND>	Интерпретатор встретил неверную или неопределенную команду.
<DDPER>	Ошибка распределенной обработки данных (DDP). 
<DIVER>	Сделана попытка разделить число на ноль.
<DKFUL>	В рамках пределов роста текущего КИПа в базе данных нет свободного места. Информация, которую система должна была записать на диск, утрачена. Может стать некорректной база данных. 
<DKHER>	Система MSM обнаружила неисправимую ошибку чтения или записи на диск. Это может быть вызвано сбоем аппаратуры или попыткой выйти за физические пределы базы данных. 
<DKRES>	Попытка разместить блок в зарезервированной области в конце области расширения. Если поле дополнительной информации в $ZERROR содержит 0, запись несостоялась, если 1, операция была завершена. 
<DKSER>	Блок, прочитанный с диска, имеет не тот тип, который система ожидала, или его внутренняя структура нарушена. Это может случиться, если база данных некоректна как следствие сбоя аппаратуры (напр. потери питания) или неисправимой ошибкой при записи блока.
<DPARM> Неправильное использование передачи параметров.
<DSCON>	Текущее устройство отсоединено от системы.
<DSTDB>	Сетевая связь оборвалась при передаче данных по (DDP).
<ECODE>	Попытка присвоить $ECODE неверное значение или обработка ошибки вызвана изменением значения $ECODE с пустого на допустимое.
<EXPER> Ошибка при возведении в степень.
<FUNCT>	Интерпретатор обнаружил неопределенную или неверно использованную функцию.
<INDER>	Интерпретатор обнаружил незаконное или неправильное использование косвенности.
<INHIB>	Доступ к базе данных по сети невозможен, потому что на удаленной машине запрещены чтения или записи базы данных.
<INRPT>	ОС получили прерывание с терминала, когда прерывание было разрешено (действовала BREAK 1). 
<ISYNT> Попытка вставки неправильной строки в программный буфер. Такое может случиться, если строка слишком длинна или имеет некорректную метку, или разделитель между меткой и телом строки неправильный, а также при вставке пустой строки. При вставке в командном режиме разделитель должен быть символом горизонтальной табуляции, при использовании команды ZINSERT - один или более пробелов или табуляций.
<KLJOB>	Задание было уничтожено или прервано утилитой KILLJOB.
<LCNSE> Попытка превышения лицензионных прав.
<LINER>	Ссылка на несуществующую в программе строку.
<MAPER>	Блок, который пытаются освободить, уже помечен свободным в соответствующем блоке карты.
<MERGE>	Выдана команда MERGE, в которой один из оперендов является потомком другого операнда.
<MINUS>	Интерпретатор обнаружил отрицательное число или нуль там, где ожидал увидеть положительное число.
<MODER>	Попытка осуществить доступ к устройству не в том режиме, с которым оно было открыто.
<MTERR>	Произошла ошибка обмена данными с магнитной лентой.
<MWAPI>	Ошибка при использовании M Windowing API.
<MXMEM>	Адрес памяти в команде или в функции VIEW вышел за пределы, разрешенные в MSM. 
<MXNUM>	Зачение числа превышает максимально разрешенное в системе.
<MXSTR>	Длина строки превышает допустимый в системе максимум. Для глобалов это составляет 255 символов (опционально 511), для локальных переменных может быть установлено в разделе, но не больше 32767. 
<NAKED>	Неверная голая ссылка. Такое может быть, если индикатор голой ссылки не установлен (пуст) или установлен в ссылку без индексов. 
<NODEV>	Программа пытается открыть устройство, не определенное в системе. 
<NOJRN>	Попытка жулналировать глобал в однопользовательском режиме.
<NOPEN>	Программа пытается использовать неоткрытое ею устройство.
<NOPGM>	Ссылка на программу, отсутствующую в путях поиска программ, определенных для задания.
<NOSYS> Ссылка на несуществующую систему (DDP) или несуществующую группу томов (расширенный синтаксис).
<NOUCI> Ссылка на несуществующий КИП при использовании расширенного синтаксиса.
<OBJCT>	Ошибка при использовании ссылки на объект.
<PCERR>	Интерпретатор обнаружил недопустимое постусловие или постусловие с неверным аргументом.
<PGMOV>	Для завершения затребованной операции в разделе недостаточно памяти. 
<PLDER>	Загруженная программа содержит устаревший p-код или p-код не того типа, которой требуется удаленной группе томов, исполняющей программу. 
<PROT>	Сделана попытка  доступа к защищенному глобалу. Может также случиться при попытке сохранить процентную программу в небиблиотечном КИПе.
<SBSCR>	Незаконный индекс в ссылке на локальную или глобальную переменную. Это может случиться, если индекс пуст или содержит ASCII NULL ($C(0)), или длиннее 255 символов, или суммарная длина глобальной ссылки (имя, скобки, индексы и запятые) превышает 255. 
<SPOOL>	Переполнение области спулинга MSM.
<STKOV> Пареполнение системного стека в результате вложенных косвенностей и вызовов программ или переполнение стека выражений при вычислении сложных выражений или сохранении больших программ.
<SYNTX>	Интерпретатор обнаружил в выполняемой строке синтаксическую ошибку. 
<SYSTM>	Система MSM обнаружила внутреннюю ошибку. Точное содержание сообщения об ошибке, включая старший и младший коды ошибки, необходимо сообщить в Micronetics. 
<TXPER> Ошибка при обработке транзакции.
<UNDEF>	Попытка обратиться к несуществующей локальной или глобальной или структурированной системной переменной или к несуществующему методу или свойству объекта.
<VWERR>	Попытка доступа к устройству с разделяемым буфером VIEW, не будучи владельцем устройств VIEW (устройства 63). Эта же ошибка может случиться, если закрыть устройство VIEW раньше, чем устройство, разделяющее с ним буфер VIEW. 
<XCALL>	Имя функции, указанное в ссылке к внешней программе не существует или передаваемые параметры не годятся.
<ZSAVE>	Одна из строк сохраняемой программы (или ее p-код) не помещается в блок. Необходимо разбить ее на две или более строки.
<ZSVGP>	Команда ZSAVE выдана для группы томов, для которой не определен никакой тип p-кода.